"filename", "language", "Markdown", "Log", "Python", "toml", "comment", "blank", "total"
"d:\项目\计算机网络课设\LightweightPacketAnalyzer\README.md", "Markdown", 6, 0, 0, 0, 0, 1, 7
"d:\项目\计算机网络课设\LightweightPacketAnalyzer\debug_gui_startup.py", "Python", 0, 0, 175, 0, 27, 47, 249
"d:\项目\计算机网络课设\LightweightPacketAnalyzer\pyproject.toml", "toml", 0, 0, 0, 1, 0, 0, 1
"d:\项目\计算机网络课设\LightweightPacketAnalyzer\src\network_analyzer\config\settings.py", "Python", 0, 0, 58, 0, 51, 16, 125
"d:\项目\计算机网络课设\LightweightPacketAnalyzer\src\network_analyzer\gui\dialogs\settings_dialog.py", "Python", 0, 0, 25, 0, 6, 6, 37
"d:\项目\计算机网络课设\LightweightPacketAnalyzer\src\network_analyzer\gui\dialogs\theme_settings_tab.py", "Python", 0, 0, 341, 0, 117, 99, 557
"d:\项目\计算机网络课设\LightweightPacketAnalyzer\src\network_analyzer\gui\main_window.py", "Python", 0, 0, 76, 0, 22, 12, 110
"d:\项目\计算机网络课设\LightweightPacketAnalyzer\src\network_analyzer\gui\theme_manager.py", "Python", 0, 0, 184, 0, 109, 50, 343
"d:\项目\计算机网络课设\LightweightPacketAnalyzer\test_complete_theme_system.py", "Python", 0, 0, 299, 0, 49, 82, 430
"d:\项目\计算机网络课设\LightweightPacketAnalyzer\test_main_window_theme.py", "Python", 0, 0, 151, 0, 36, 50, 237
"d:\项目\计算机网络课设\LightweightPacketAnalyzer\test_main_window_theme_simple.py", "Python", 0, 0, 166, 0, 32, 51, 249
"d:\项目\计算机网络课设\LightweightPacketAnalyzer\test_mainwindow_simple.py", "Python", 0, 0, 27, 0, 12, 12, 51
"d:\项目\计算机网络课设\LightweightPacketAnalyzer\test_settings_dialog_integration.py", "Python", 0, 0, 220, 0, 44, 73, 337
"d:\项目\计算机网络课设\LightweightPacketAnalyzer\test_t6_verification.py", "Python", 0, 0, 175, 0, 30, 53, 258
"d:\项目\计算机网络课设\LightweightPacketAnalyzer\test_theme_settings_simple.py", "Python", 0, 0, 195, 0, 34, 51, 280
"d:\项目\计算机网络课设\LightweightPacketAnalyzer\test_theme_settings_tab.py", "Python", 0, 0, 202, 0, 42, 63, 307
"d:\项目\计算机网络课设\LightweightPacketAnalyzer\test_theme_system.py", "Python", 0, 0, 141, 0, 35, 49, 225
"d:\项目\计算机网络课设\LightweightPacketAnalyzer\test_ttkbootstrap_install.py", "Python", 0, 0, 81, 0, 17, 21, 119
"d:\项目\计算机网络课设\LightweightPacketAnalyzer\test_ui_step_by_step.py", "Python", 0, 0, 88, 0, 20, 30, 138
"d:\项目\计算机网络课设\docs\ttkbootstrap主题切换\ACCEPTANCE_ttkbootstrap主题切换.md", "Markdown", 204, 0, 0, 0, 0, 51, 255
"d:\项目\计算机网络课设\docs\ttkbootstrap主题切换\ALIGNMENT_ttkbootstrap主题切换.md", "Markdown", 150, 0, 0, 0, 0, 35, 185
"d:\项目\计算机网络课设\docs\ttkbootstrap主题切换\APPROVAL_ttkbootstrap主题切换.md", "Markdown", 133, 0, 0, 0, 0, 37, 170
"d:\项目\计算机网络课设\docs\ttkbootstrap主题切换\CONSENSUS_ttkbootstrap主题切换.md", "Markdown", 72, 0, 0, 0, 0, 10, 82
"d:\项目\计算机网络课设\docs\ttkbootstrap主题切换\DESIGN_ttkbootstrap主题切换.md", "Markdown", 301, 0, 0, 0, 0, 66, 367
"d:\项目\计算机网络课设\docs\ttkbootstrap主题切换\FINAL_ttkbootstrap主题切换.md", "Markdown", 153, 0, 0, 0, 0, 41, 194
"d:\项目\计算机网络课设\docs\ttkbootstrap主题切换\TASK_ttkbootstrap主题切换.md", "Markdown", 292, 0, 0, 0, 0, 73, 365
"d:\项目\计算机网络课设\docs\ttkbootstrap主题切换\TODO_ttkbootstrap主题切换.md", "Markdown", 130, 0, 0, 0, 0, 35, 165
"d:\项目\计算机网络课设\logs\network_analyzer.log", "Log", 0, 223, 0, 0, 0, 0, 223
"Total", "-", 1441, 223, 2604, 1, 683, 1114, 6066